N{Time num=S}*	taɪm	1
N{Time num=P}*	taɪmz	1
N{Year num=S}*	jɪə	1
N{Year num=P}*	jɪəz	1
N{People num=S}*	piːpəl	1
N{People num=P}*	piːpəlz	1
N{Way num=S}*	weɪ	1
N{Way num=P}*	weɪz	1
N{Day num=S}*	deɪ	1
N{Day num=P}*	deɪz	1
N{Man num=S}*	mæn	1
N{Man num=P}*	mɛn	1
N{Thing num=S}*	θɪŋ	1
N{Thing num=P}*	θɪŋz	1
N{Place num=S}*	pleɪs	1
N{Place num=P}*	pleɪsɪz	1
N{Case num=S}*	keɪs	1
N{Case num=P}*	keɪsɪz	1
N{Rose num=S}*	ɹəʊz	1
N{Rose num=P}*	ɹəʊzɪz	1
N{Moose num=S}*	muːs	1
N{Moose num=P}*	muːsɪz	1