a	a
ab1:	abɛ̃:
abeilles	abɛj
acce	aks
accent	aksɑ̃
accidents	aksidɑ̃
accompagnatrices	akɔ̃paɲatʁis
actions	aksjɔ̃
activistes	aktivist
activités	aktivite
ad1:	adɛ̃:
adaptation	adaptasjɔ̃
adjoint	adʒwɛ̃
administratives	administʁativ
adresses	adʁɛs
adultes	adylt
affaires	afɛʁ
agréable	aɡʁeabl
ah	a
aiguilles	eɡɥij
allemande	almɑ̃d
allemands	almɑ̃
aller	ale
aller-retour	alɛʁtuʁ
alteuh	altø
amateurs	amatœʁ
ambiance	ɑ̃bjɑ̃s
ambiances	ɑ̃bjɑ̃s
ami	ami
amicale	amikal
amie	ami
amis	ami
amour	amuʁ
américaine	ameʁikɛn
américains	ameʁikɛ̃
an	ɑ̃
analyste	analist
ancillaires	ɑ̃silɛʁ
anecdotes	anɛkdɔt
anglais	ɑ̃ɡlɛ
animaux	animo
animé	anime
animés	anime
annuel	anɥɛl
année	ane
années	ane
ans	ɑ̃
ant	ɑ̃
antenne	ɑ̃tɛn
appareil	apaʁɛj
appareils	apaʁɛj
appart	apaʁ
appartement	apaʁtəmɑ̃
appartements	apaʁtəmɑ̃
apparts	apaʁ
appel	apɛl
apprentissage	apʁɑ̃tisaʒ
approche	apʁɔʃ
après-midi	apʁɛsmidi
arbre	aʁbʁ
arbres	aʁbʁ
armes	aʁm
arrondissement	aʁɔ̃dismɑ̃
articles	aʁtikl
artistiques	aʁtistik
aspect	aspɛ
association	asɔsjasjɔ̃
astuce	astys
astuces	astys
atelier	atəlje
atmosphère	atmɔsfɛʁ
attends	atɑ̃
attentats	atɑ̃ta
attention	atɑ̃sjɔ̃
attirance	atiʁɑ̃s
au	o
aucun	okɛ̃
aucune	okyn
aujourd'hui	oʒuʁdɥi
automatismes	ɔtɔmatism
autorité	ɔtɔʁite
autre	otʁ
autres	otʁ
avantage	avɑ̃taʒ
aveyron	aveʁɔ̃
aveyronnais	aveʁɔnɛ
aveyronnaises	aveʁɔnɛz
avis	avi
aéré	aeʁe
b:	be:
bac	bak
badigeonnée	badiʒɔne
baffe	baf
bah	ba
bain	bɛ̃
bains	bɛ̃
balance	balɑ̃s
balcon	balkɔ̃
bancal	bɑ̃kal
bande	bɑ̃d
banque	bɑ̃k
banques	bɑ̃k
banquet	bɑ̃kɛ
banquets	bɑ̃kɛ
banquier	bɑ̃kje
barages	baʁaʒ
barrages	baʁaʒ
base	baz
basque	bask
basse	bas
bataille	bataj
bd:	b:
bea	bi
beau	bo
beau-père	bopɛʁ
beauté	bote
belle	bɛl
belle-mère	bɛlmɛʁ
belles	bɛl
ben	bɛ̃
bep	bɛ
besoin	bəzwɛ̃
bestioles	bɛstjɔl
bicyclettes	bisiklɛt
bise	biz
bizarre	bizaʁ
blanc	blɑ̃
blanche	blɑ̃ʃ
blesser	blese
bm:	bm:
boite	bwat
bol	bɔl
bon	bɔ̃
bonbon	bɔ̃bɔ̃
bonne	bɔn
bonnes	bɔn
bons	bɔ̃
bords	bɔʁ
boris	bɔʁi
bougnats	buɲa
boulangerie	bulɑ̃ʒʁi
boule	bul
bouloire	bulwaʁ
boulot	bulo
bourgeoise	buʁʒwaz
bout	bu
bouteilles	butɛj
boutique	butik
boutiques	butik
boutons	butɔ̃
boîte	bwat
boîtes	bwat
bretagne	bʁətaɲ
bretons	bʁətɔ̃
brevet	bʁəvɛ
bruit	bʁɥi
bruyants	bʁɥijɑ̃
bts	b
bureau	byʁo
but	by
bébé	bebe
bébés	bebe
bête	bɛt
c'est	sɛ
c'est-à-dire	sɛtadiʁ
c'était	setɛ
ca	ka
cabriolet	kabʁijɔlɛ
cadeau	kado
cadeaux	kado
cadre	kadʁ
café	kafe
cafés	kafe
cage	kaʒ
caisse	kɛs
calendrier	kalɑ̃dʁije
calme	kalm
camarades	kamaʁad
camions	kamjɔ̃
campagne	kɑ̃paɲ
canada	kanada
canette	kanɛt
canicule	kanikyl
cannabis	kanabis
cap	kap
capes	kap
caractère	kaʁaktɛʁ
caractères	kaʁaktɛʁ
caractéristiques	kaʁakteʁistik
cardiaques	kaʁdjak
carences	kaʁɑ̃s
carpettes	kaʁpɛt
carrière	kaʁjɛʁ
carrières	kaʁjɛʁ
carré	kaʁe
carrés	kaʁe
carte	kaʁt
cas	ka
cas-là	ka-la
casque	kask
catalogue	katalɔɡ
catherinettes	katʁinɛt
catherinettes-là	katʁinɛt-la
caves	kav
ce	sə
celui-là	səlɥi-la
censurée	sɑ̃syʁe
cent	sɑ̃
centimètres	sɑ̃timɛtʁ
centre	sɑ̃tʁ
cents	sɑ̃
certain	sɛʁtɛ̃
certaine	sɛʁtɛn
certaines	sɛʁtɛn
certains	sɛʁtɛ̃
certificat	sɛʁtifika
certificats	sɛʁtifika
ces	se
cet	sɛt
cette	sɛt
ch	ʃ
chambre	ʃɑ̃bʁ
chambres	ʃɑ̃bʁ
champ	ʃɑ̃
champignon	ʃɑ̃piɲɔ̃
champion	ʃɑ̃pjɔ̃
chance	ʃɑ̃s
chanson	ʃɑ̃sɔ̃
chansons	ʃɑ̃sɔ̃
chanteurs	ʃɑ̃tœʁ
chapeau	ʃapo
chaque	ʃak
charcuterie	ʃaʁkytʁi
charmant	ʃaʁmɑ̃
chat	ʃa
chat!'	ʃa!'
chattesqui	ʃatɛski
chaude	ʃod
chaudes	ʃod
chauffantes	ʃofɑ̃t
chauffeurs	ʃofœʁ
chaussures	ʃosyʁ
chaîne	ʃɛn
chef	ʃɛf
chemin	ʃəmɛ̃
chemises	ʃəmiz
cher	ʃɛʁ
chercheur	ʃɛʁʃœʁ
chercheurs	ʃɛʁʃœʁ
chevaliers	ʃəvalje
cheveux	ʃəvø
chien	ʃjɛ̃
chiens	ʃjɛ̃
choix	ʃwa
chorale	kɔʁal
choré	kɔʁe
chorégraphe	kɔʁeɡʁaf
chorégraphie	kɔʁeɡʁafi
chose	ʃoz
choses	ʃoz
chou	ʃu
choux	ʃu
chsur	ʃsyʁ
chômage	ʃomaʒ
chômeurs	ʃomœʁ
cinq	sɛ̃k
cinquantaine	sɛ̃kɑ̃tɛn
cinquante	sɛ̃kɑ̃t
cinéma	sinema
circuits	siʁkɥi
cité	site
cj:	kʒ:
claque	klak
classe	klas
classique	klasik
classiques	klasik
clients	klijɑ̃
climatisation	klimatizasjɔ̃
clodos	klɔdo
cléta	kleta
cm	km
cm1:	kmɛ̃:
cmu	kmy
co	ko
cochère	kɔʃɛʁ
coiffure	kwafyʁ
coin	kwɛ̃
coins	kwɛ̃
collecte	kɔlɛkt
collège	kɔlɛʒ
collègues	kɔlɛɡ
coloc	kɔlɔk
colocs	kɔlɔk
colère	kɔlɛʁ
com	kɔ̃
commerce	kɔmɛʁs
commune	kɔmyn
communes	kɔmyn
compatriotes	kɔ̃patʁijɔt
compliqué	kɔ̃plike
compreniez	kɔ̃pʁənje
comptabilité	kɔ̃tabilite
comptable	kɔ̃tabl
compte	kɔ̃t
comédies	kɔmedi
concours	kɔ̃kuʁ
conditions	kɔ̃disjɔ̃
confiture	kɔ̃fityʁ
confort	kɔ̃fɔʁ
confusion	kɔ̃fyzjɔ̃
congrès	kɔ̃ɡʁɛ
conjugaison	kɔ̃ʒyɡɛzɔ̃
consciencieuse	kɔ̃sjɑ̃sjøz
conseils	kɔ̃sɛj
consultation	kɔ̃syltasjɔ̃
consultations	kɔ̃syltasjɔ̃
conséquences	kɔ̃sekɑ̃s
contacts	kɔ̃takt
contents	kɔ̃tɑ̃
continue	kɔ̃tiny
contrat	kɔ̃tʁa
contrôleurs	kɔ̃tʁolœʁ
cop	ko
copains	kɔpɛ̃
copine	kɔpin
copines	kɔpin
corbeilles	kɔʁbɛj
correction	kɔʁɛksjɔ̃
correspondance	kɔʁɛspɔ̃dɑ̃s
cote	kɔt
cou	ku
coucou	kuku
coul	kul
couleurs	kulœʁ
couloir	kulwaʁ
coup	ku
coups	ku
cour	kuʁ
cours	kuʁ
course	kuʁs
course-là	kuʁsə-la
cous	ku
cousins	kuzɛ̃
couverture	kuvɛʁtyʁ
cr:	kʁ:
crasse	kʁas
crise	kʁiz
cuillère	kɥijɛʁ
cuir	kɥiʁ
cuisine	kɥizin
cuisinés	kɥizine
cuisses	kɥis
cur	kyʁ
curieux	kyʁjø
cursus	kyʁsys
céline	selin
côte	kot
côté	kote
côté-là	kote-la
d	de
d'abord	dabɔʁ
d'accord	dakɔʁ
d'activité	daktivite
d'ailleurs	dajœʁ
d'anglais	dɑ̃ɡlɛ
d'août	dut
d'auteur	dotœʁ
d'autre	dotʁ
d'autres	dotʁ
d'avant	davɑ̃
d'effet	defɛ
d'entente	dɑ̃tɑ̃t
d'ergo	dɛʁɡo
d'histoire	distwaʁ
d'iden	didɑ̃
d'immigrès	dimiɡʁɛ
d'imprimantes	dɛ̃pʁimɑ̃t
d'influences	dɛ̃flyɑ̃s
d'instruments	dɛ̃stʁymɑ̃
d'oc	dɔk
d'op	dɔp
d'origine	dɔʁiʒin
d'où	du
d'un	dɛ̃
d'une	dyn
d'édition	dedisjɔ̃
d'étude	detyd
d'être	dɛtʁ
danger	dɑ̃ʒe
danse	dɑ̃s
date	dat
de	də
degré	dəɡʁe
degrés	dəɡʁe
demi	dəmi
densité	dɑ̃site
dents	dɑ̃
dernier	dɛʁnje
derniers	dɛʁnje
dernière	dɛʁnjɛʁ
dernières	dɛʁnjɛʁ
des	de
dess	dɛs
dessin	desɛ̃
dessins	desɛ̃
deux	dø
deuxième	døzjɛm
dialecte	djalɛkt
dictateur	diktatœʁ
dictées	dikte
difficile	difisil
difficiles	difisil
différence	difeʁɑ̃s
différent	difeʁɑ̃
différentes	difeʁɑ̃t
dimanche	dimɑ̃ʃ
dingue	dɛ̃ɡ
diplôme	diplom
directeur	diʁɛktœʁ
direction	diʁɛksjɔ̃
directrice	diʁɛktʁis
dirigeants	diʁiʒɑ̃
discours	diskuʁ
discussion	diskysjɔ̃
dispute	dispyt
distillerie	distilʁi
division	divizjɔ̃
divisions	divizjɔ̃
dix	dis
dix-huitième	diksɥitjɛm
dix-neuf	diz-nœf
dixième	dizjɛm
dizaine	dizɛn
dizaines	dizɛn
diététique	djetetik
domaine	dɔmɛn
domaines	dɔmɛn
domestique	dɔmɛstik
domicile	dɔmisil
domiciles	dɔmisil
dommage	dɔmaʒ
donc	dɔ̃k
dossier	dosje
double	dubl
douche	duʃ
douzaine	duzɛn
douze	duz
douzième	duzjɛm
drame	dʁam
droit	dʁwa
droits	dʁwa
drôle	dʁol
drôles	dʁol
du	dy
durcit	dyʁsi
dure	dyʁ
dé	de
débordements	debɔʁdəmɑ̃
début	deby
débuts	deby
décembre"	desɑ̃bʁ"
déception	desɛpsjɔ̃
décibel	desibɛl
décoration	dekɔʁasjɔ̃
dédé	dede
défaut	defo
défis	defi
défit	defi
déjeuner	deʒœne
démarche	demaʁʃ
démarches	demaʁʃ
dénivelé	denivle
dépendante	depɑ̃dɑ̃t
dépêche	depɛʃ
désespéré	dezɛspeʁe
désir	deziʁ
détail	detaj
développement	devlɔpmɑ̃
e	ə
e:	ə:
e:c'est	əkɛst
efforts	efɔʁ
eh	e
elissa	əlisa
elle	ɛl
en	ɑ̃
encasernés	ɑ̃kazɛʁne
endroit	ɑ̃dʁwa
enfant	ɑ̃fɑ̃
enfant2:	ɑ̃fɑ̃tdø:
enfants	ɑ̃fɑ̃
ennuyeux	ɑ̃nɥijø
enquête	ɑ̃kɛt
ens	ɑ̃
enseignants	ɑ̃sɛɲɑ̃
ensemble	ɑ̃sɑ̃bl
entier"	ɑ̃tje"
entier'	ɑ̃tje'
entière	ɑ̃tjɛʁ
entraînement	ɑ̃tʁɛnmɑ̃
entrée	ɑ̃tʁe
envie	ɑ̃vi
envies	ɑ̃vi
ep1:	əpɛ̃:
ergothérapeute	ɛʁɡɔteʁapøt
escapades	ɛskapad
espagne	ɛspaɲ
espoir	ɛspwaʁ
espèce	ɛspɛs
espèces	ɛspɛs
essentiel	esɑ̃sjɛl
est-ce	ɛ-s
et	e
etat	əta
euh	ø
euhe:	ø:
euros	øʁo
eux-mêmes	ømɛm
exacte	ɛɡzakt
exactement	ɛɡzaktəmɑ̃
examen	ɛɡzamɛ̃
exemple	ɛɡzɑ̃pl
explosion	ɛksplozjɔ̃
expérience	ɛkspeʁjɑ̃s
extra	ɛkstʁa
extraordinaire	ɛkstʁaɔʁdinɛʁ
extrêmes	ɛkstʁɛm
fac	fak
facile	fasil
facilité	fasilite
faculté	fakylte
faiblesses	fɛblɛs
fait	fɛ
faits	fɛ
fam	fɑ̃
familial	familjal
familiale	familjal
famille	famij
familles	famij
fanatiques	fanatik
farfouille	faʁfuj
faute	fot
fautes	fot
façon	fasɔ̃
façons	fasɔ̃
femme	fam
femmes	fam
fenêtre	fənɛtʁ
ferme	fɛʁm
feu	fø
feuilleton	fœjtɔ̃
fgn	fɲ
fil	fil
filiale	filjal
filiales	filjal
fille	fij
filles	fij
film	film
film'	film'
films	film
fils	fis
fin	fɛ̃
financier	finɑ̃sje
financiers	finɑ̃sje
flh	fl
fois	fwa
fond	fɔ̃
fondamentale	fɔ̃damɑ̃tal
forcément	fɔʁsemɑ̃
forfait	fɔʁfɛ
forfait-repas	fɔʁfɛtʁəpa
formation	fɔʁmasjɔ̃
formes	fɔʁm
forts	fɔʁ
forêt	fɔʁɛ
fou	fu
foule	ful
foyer	fwaje
francais	fʁɑ̃kɛ
france	fʁɑ̃s
franco-polonaise	fʁɑ̃kɔpɔlɔnɛz
francs	fʁɑ̃
français	fʁɑ̃sɛ
française	fʁɑ̃sɛz
françaises	fʁɑ̃sɛz
françois	fʁɑ̃swa
frites	fʁit
froids	fʁwa
fruit	fʁɥi
frère	fʁɛʁ
frère'	fʁɛʁ'
frères	fʁɛʁ
février	fevʁije
fêtards	fetaʁ
fête	fɛt
ga	ɡa
galère	ɡalɛʁ
gamin	ɡamɛ̃
gamins	ɡamɛ̃
garage	ɡaʁaʒ
garcons	ɡaʁkɔ̃
garde	ɡaʁd
gare	ɡaʁ
gares	ɡaʁ
gars	ɡa
garçon	ɡaʁsɔ̃
garçons	ɡaʁsɔ̃
gastro	ɡastʁo
gelée	ʒəle
gendre	ʒɑ̃dʁ
geneviève	ʒənvjɛv
genres	ʒɑ̃ʁ
gens	ʒɑ̃
gens-là	ʒɑ̃-la
gentil	ʒɑ̃ti
georges	ʒɔʁʒ
germain	ʒɛʁmɛ̃
geste	ʒɛst
gestes	ʒɛst
geysi	ʒizi
gibier	ʒibje
gitans'	ʒitɑ̃'
globale	ɡlɔbal
gn	ɲ
gorges	ɡɔʁʒ
gosse	ɡɔs
gosses	ɡɔs
gouvernement	ɡuvɛʁnəmɑ̃
goût	ɡu
grain	ɡʁɛ̃
grand	ɡʁɑ̃
grand-mère	ɡʁɑ̃dmɛʁ
grand-père	ɡʁɑ̃pɛʁ
grande	ɡʁɑ̃d
grandes	ɡʁɑ̃d
grands-parents	ɡʁɑ̃dspaʁɑ̃
grave	ɡʁav
graves	ɡʁav
gros	ɡʁo
grosse	ɡʁos
grosses	ɡʁos
groupe	ɡʁup
gue	ɡə
guerre	ɡɛʁ
gueule	ɡœl
guillemets	ɡijmɛ
gémeaux	ʒemo
général	ʒeneʁal
générale	ʒeneʁal
génération	ʒeneʁasjɔ̃
générations	ʒeneʁasjɔ̃
géographie	ʒeɔɡʁafi
ha	a
habitants	abitɑ̃
habitude	abityd
habitudes	abityd
habituels	abitɥɛl
habité	abite
handicap	ɑ̃dikap
hasard	azaʁ
haut	o
haut-parleur:	otpaʁlœʁ:
hein	ɛ̃
heu	ø
heure	œʁ
heures	œʁ
hi	i
histoire	istwaʁ
historiques	istɔʁik
hivers	ivɛʁ
homme	ɔm
homme:	ɔm:
hommes	ɔm
honneur	ɔnœʁ
honteux	ɔ̃tø
horaires	ɔʁɛʁ
horrible	ɔʁibl
huit	ɥit
hum	œm
hé	e
idées	ide
il	il
immeuble	imœbl
immeubles	imœbl
impasse	ɛ̃pas
impeccable	ɛ̃pekabl
importance	ɛ̃pɔʁtɑ̃s
important	ɛ̃pɔʁtɑ̃
impôts	ɛ̃po
incroyable!	ɛ̃kʁwajabl!
incroyables	ɛ̃kʁwajabl
indigestion	ɛ̃diʒɛstjɔ̃
inestimable	inɛstimabl
informaticien	ɛ̃fɔʁmatisjɛ̃
informatiques	ɛ̃fɔʁmatik
infusion	ɛ̃fyzjɔ̃
initiale	inisjal
inspecteur	ɛ̃spɛktœʁ
institu	ɛ̃stity
instruments	ɛ̃stʁymɑ̃
insuffisant	ɛ̃syfizɑ̃
interim	ɛ̃tɛʁim
internationale	ɛ̃tɛʁnasjɔnal
intégration	ɛ̃teɡʁasjɔ̃
intéressants	ɛ̃teʁesɑ̃
intérêt	ɛ̃teʁɛ
invitations	ɛ̃vitasjɔ̃
inégale	ineɡal
ira-t-il	iʁa-til
irréversible	iʁevɛʁsibl
j'ai	ʒe
j'aime	ʒɛm
j'attends	ʒatɑ̃
j'avais	ʒavɛ
j'étais	ʒetɛ
jai	ʒɛ
jambe	ʒɑ̃b
japon	ʒapɔ̃
japonaise	ʒapɔnɛz
jardin	ʒaʁdɛ̃
jardinier	ʒaʁdinje
jaune	ʒon
javel	ʒavɛl
jean-pierre	ʒanpjɛʁ
jeudi	ʒødi
jeune	ʒœn
jeunes	ʒœn
jeunesse	ʒœnɛs
jeux	ʒø
jeûne	ʒøn
jo1:	ʒun:
joli	ʒɔli
jolie	ʒɔli
jolis	ʒɔli
jour	ʒuʁ
journée	ʒuʁne
journées	ʒuʁne
jours	ʒuʁ
juin	ʒɥɛ̃
juste	ʒyst
kettel	ketɛl
kilo	kilo
kilomètres	kilɔmɛtʁ
kilos	kilo
kinou	kinu
kiné	kine
kokloma	kɔklɔma
l	ɛl
l'	ɛl'
l'action	laksjɔ̃
l'activité	laktivite
l'affaire	lafɛʁ
l'afrique	lafʁik
l'an	lɑ̃
l'ancienne	lɑ̃sjɛn
l'année	lane
l'armée	laʁme
l'attendais	latɑ̃dɛ
l'autre	lotʁ
l'aîné	lene
l'enseignement	lɑ̃sɛɲmɑ̃
l'entendre	lɑ̃tɑ̃dʁ
l'entends	lɑ̃tɑ̃
l'expression	lɛkspʁesjɔ̃
l'hôpital	lɔpital
l'im	lim
l'image	limaʒ
l'immeuble	limœbl
l'informatique	lɛ̃fɔʁmatik
l'objectif	lɔbʒɛktif
l'offensive	lɔfɑ̃siv
l'économie	lekɔnɔmi
l'électronique	lelɛktʁɔnik
l'époque	lepɔk
la	la
la:	la:
laboratoire	labɔʁatwaʁ
lait	lɛ
lampe	lɑ̃p
langage	lɑ̃ɡaʒ
langue	lɑ̃ɡ
langues	lɑ̃ɡ
lapin	lapɛ̃
lapins	lapɛ̃
larmes	laʁm
latins	latɛ̃
laurence	loʁɑ̃s
laurence:	loʁɑ̃s:
le	lə
le:	lə:
lecture	lɛktyʁ
lendemain	lɑ̃dmɛ̃
les	le
lettre	lɛtʁ
leuleur	lœlœʁ
leuleurs	lœlœʁ
leur	lœʁ
leurs	lœʁ
lexical	lɛksikal
lh	l
liaison	ljɛzɔ̃
liberté	libɛʁte
libération	libeʁasjɔ̃
licence	lisɑ̃s
lieu	ljø
ligne	liɲ
limite	limit
linguistique	lɛ̃ɡɥistik
linlin	lɛ̃lɛ̃
liquette	likɛt
lit	li
litres	litʁ
lits	li
littéraire	liteʁɛʁ
livre	livʁ
livres	livʁ
local	lɔkal
lockoute	lɔkut
logement	lɔʒmɑ̃
logements	lɔʒmɑ̃
logiciel	lɔʒisjɛl
logiciels	lɔʒisjɛl
loi	lwa
lois	lwa
longue	lɔ̃ɡ
lot	lo
lozère	lozɛʁ
ls:	l:
lui	lɥi
lycée	lise
lycées	lise
lyon	ljɔ̃
lyriques	liʁik
là-bas	laba
là-dessus	la-dəsy
légende	leʒɑ̃d
légumes	leɡym
m	ɛm
m'	ɛm'
m'a	ma
m'arrangeait	maʁɑ̃ʒɛ
m'avait	mavɛ
m'en	mɑ̃
m'énerve	menɛʁv
ma	ma
machin	maʃɛ̃
machine	maʃin
machines	maʃin
machos	matʃo
madame	madam
magasin	maɡazɛ̃
magasins	maɡazɛ̃
magnifique	maɲifik
magnifiques	maɲifik
magreb	maɡʁɛb
mai	mɛ
main	mɛ̃
maire	mɛʁ
mairie	mɛʁi
maison	mɛzɔ̃
maisons	mɛzɔ̃
mal	mal
malade	malad
malaise	malɛz
malpropre	malpʁɔpʁ
maman	mamɑ̃
manie	mani
manière	manjɛʁ
manque	mɑ̃k
manuelle	manɥɛl
marché	maʁʃe
marchés	maʁʃe
mari	maʁi
mariage	maʁjaʒ
marque	maʁk
marqué	maʁke
marre	maʁ
masse	mas
maternelle	matɛʁnɛl
maths	mat
matin	matɛ̃
matériel	mateʁjɛl
mauvais	movɛ
mauvaises	movɛz
mb1:	mbɛ̃:
me	mə
mec	mɛk
meilleur	mɛjœʁ
meilleures	mɛjœʁ
membre	mɑ̃bʁ
mentalité	mɑ̃talite
mention	mɑ̃sjɔ̃
mer	mɛʁ
mercredi	mɛʁkʁədi
merde	mɛʁd
mes	me
mesquineries	mɛskinʁi
messe	mɛs
micro-processeurs	mikʁɔpʁɔsesœʁ
mignon	miɲɔ̃
milieu	miljø
militaire	militɛʁ
militaires	militɛʁ
mille	mil
milles	mil
milliards	miljaʁ
milliers	milje
millieurs	miljœʁ
min	mɛ̃
mince!	mɛ̃s!
mini	mini
minimum	minimɔm
ministre	ministʁ
minsitre	mɛ̃sitʁ
minutes)	minyt)
mises	miz
misère	mizɛʁ
misère;	mizɛʁ;
modèle	mɔdɛl
modèles	mɔdɛl
modérateur	mɔdeʁatœʁ
moi-même	mwamɛm
mois	mwa
moitié	mwatje
mollets	mɔlɛ
moment	mɔmɑ̃
moment-là	mɔmɑ̃-la
mon	mɔ̃
mondanités	mɔ̃danite
monde	mɔ̃d
monnaie	mɔnɛ
monsieur	məsjø
mont	mɔ̃
montagnes	mɔ̃taɲ
mort	mɔʁ
mot	mo
motivation	mɔtivasjɔ̃
motivations	mɔtivasjɔ̃
mots	mo
mouchoir	muʃwaʁ
mouvements	muvmɑ̃
moyen	mwajɛ̃
moyenne	mwajɛn
moyens	mwajɛ̃
munition	mynisjɔ̃
mur	myʁ
musicale	myzikal
musicales	myzikal
musiciens	myzisjɛ̃
musique	myzik
musique'	myzik'
mutuelle	mytɥɛl
myopie	mjɔpi
mère	mɛʁ
mètre	mɛtʁ
mètres	mɛtʁ
mécanique	mekanik
médecin	medsɛ̃
médecins	medsɛ̃
médical	medikal
médicale	medikal
mélange	melɑ̃ʒ
mélangé	melɑ̃ʒe
ménage	menaʒ
mérite	meʁit
métier	metje
métro	metʁo
métro:	metʁo:
même	mɛm
mêmes	mɛm
môme	mom
n	ɛn
n'a	na
n'est	nɛ
national	nasjɔnal
nationale	nasjɔnal
nationalité	nasjɔnalite
nationalités	nasjɔnalite
naturel	natyʁɛl
neuf	nœf
niveau	nivo
nnécessaire	nesesɛʁ
noir	nwaʁ
noire	nwaʁ
nom	nɔ̃
nombre	nɔ̃bʁ
noms	nɔ̃
non	nɔ̃
normal	nɔʁmal
norvège	nɔʁvɛʒ
nos	no
notes	nɔt
notre	nɔtʁ
nourrices	nuʁis
nouveau	nuvo
nouvel	nuvɛl
nues	ny
nuit	nɥi
numérique	nymeʁik
numériques	nymeʁik
numéro	nymeʁo
nus	ny
nécessaire	nesesɛʁ
négatif	neɡatif
objectif	ɔbʒɛktif
obligatoire	ɔbliɡatwaʁ
obobservateur	ɔbɔpsɛʁvatœʁ
observateur	ɔpsɛʁvatœʁ
occasion	ɔkazjɔ̃
occupants	ɔkypɑ̃
occupations	ɔkypasjɔ̃
oeuf	ɔœf
officiel	ɔfisjɛl
officielle	ɔfisjɛl
officielles	ɔfisjɛl
officier	ɔfisje
oh	o
oiseaux	wazo
olympiques	ɔlɛ̃pik
on	ɔ̃
oncles	ɔ̃kl
onze	ɔ̃z
ophtalmo	ɔftalmo
opposants	ɔpozɑ̃
orale	ɔʁal
orange	ɔʁɑ̃ʒ
orchestres	ɔʁkɛstʁ
ordinateur	ɔʁdinatœʁ
ordinateurs	ɔʁdinatœʁ
ordre	ɔʁdʁ
ordres	ɔʁdʁ
organisation	ɔʁɡanizasjɔ̃
orient	ɔʁjɑ̃
orphelinats	ɔʁfəlina
ouais	wɛ
ouest	wɛst
oui	wi
ours	uʁs
ouvrier	uvʁije
p	pe
paire	pɛʁ
pancartes	pɑ̃kaʁt
pannes	pan
papa	papa
pape	pap
papier	papje
paquet	pakɛ
paradis	paʁadi
paralysée	paʁalize
parc	paʁk
pareil	paʁɛj
parents	paʁɑ̃
parents-mêmes	paʁɑ̃mɛm
parents:	paʁɑ̃:
paris	paʁi
parisienne	paʁizjɛn
parisiens	paʁizjɛ̃
parler	paʁle
parquet	paʁkɛ
parraine	paʁɛn
part	paʁ
parti	paʁti
particularité	paʁtikylaʁite
particulier	paʁtikylje
particuliers	paʁtikylje
particulières	paʁtikyljɛʁ
partie	paʁti
partitions	paʁtisjɔ̃
pas	pa
passage	pasaʒ
passé	pase
patois	patwa
patron	patʁɔ̃
patte	pat
patuès	patɥɛ
pause	poz
pauvre	povʁ
pauvres	povʁ
paye	pɛj
pays	pei
paysag	peizaɡ
paysage	peizaʒ
pd1:	pdɛ̃:
peine	pɛn
peinture	pɛ̃tyʁ
perceptions	pɛʁsɛpsjɔ̃
perruches	peʁyʃ
personnalisant	pɛʁsɔnalizɑ̃
personne	pɛʁsɔn
personnel	pɛʁsɔnɛl
personnes	pɛʁsɔn
perte	pɛʁt
petersbourg	pətɛʁsbuʁ
petit	pəti
petite	pətit
petites	pətit
petits	pəti
petits-enfants	pətitsɑ̃fɑ̃
peu	pø
peuples	pœpl
peut-être	pøtɛtʁ
photo	fɔto
photos	fɔto
phrase	fʁaz
pianiste	pjanist
piano	pjano
pieds	pje
pigeons	piʒɔ̃
pipeline	piplin
pièce	pjɛs
pièces	pjɛs
pl	pl
place	plas
plafond	plafɔ̃
plage	plaʒ
plaisir	pleziʁ
plan	plɑ̃
plaques	plak
plats	pla
plein	plɛ̃
pleine	plɛn
plu	ply
plupart	plypaʁ
plusieurs	plyzjœʁ
pneus	pnø
poche	pɔʃ
poils	pwal
point	pwɛ̃
pointe	pwɛ̃t
pointeuse	pwɛ̃tøz
pointures	pwɛ̃tyʁ
poisson	pwasɔ̃
politique	pɔlitik
politiques	pɔlitik
pont	pɔ̃
ponts	pɔ̃
population	pɔpylasjɔ̃
por	pɔʁ
porche	pɔʁʃ
porsche	pɔʁʃ
porte	pɔʁt
porte)	pɔʁt)
portes	pɔʁt
portugais	pɔʁtyɡɛ
positif	pozitif
possibilité	pɔsibilite
possible	pɔsibl
possibles	pɔsibl
postale	pɔstal
poste	pɔst
postes	pɔst
pot	po
poulet	pulɛ
poupée	pupe
pouvoir	puvwaʁ
poème	pɔɛm
pratique	pʁatik
pre	pʁ
premier	pʁəmje
premiers	pʁəmje
première	pʁəmjɛʁ
premières	pʁəmjɛʁ
pression	pʁesjɔ̃
preuve	pʁœv
primaube	pʁimob
priorité	pʁijɔʁite
priorités	pʁijɔʁite
prise	pʁiz
privé	pʁive
privées	pʁive
prix	pʁi
problème	pʁɔblɛm
problèmes	pʁɔblɛm
procession	pʁɔsesjɔ̃
prochain	pʁɔʃɛ̃
prochaine	pʁɔʃɛn
procédure	pʁɔsedyʁ
produit	pʁɔdɥi
prof	pʁɔf
professeur	pʁɔfesœʁ
profession	pʁɔfesjɔ̃
professionnel	pʁɔfesjɔnɛl
professionnelle	pʁɔfesjɔnɛl
professionnelles	pʁɔfesjɔnɛl
professionnels	pʁɔfesjɔnɛl
professions	pʁɔfesjɔ̃
professorat	pʁɔfesɔʁa
profonde"	pʁɔfɔ̃d"
profonde'	pʁɔfɔ̃d'
profs	pʁɔf
programmation	pʁɔɡʁamasjɔ̃
programmes	pʁɔɡʁam
programmeur	pʁɔɡʁamœʁ
projet	pʁɔʒɛ
projets	pʁɔʒɛ
promenade	pʁɔmnad
prononciation	pʁɔnɔ̃sjasjɔ̃
propres	pʁɔpʁ
propriétaire	pʁɔpʁijetɛʁ
prospection	pʁɔspɛksjɔ̃
proverbe	pʁɔvɛʁb
province	pʁɔvɛ̃s
précepteurs	pʁesɛptœʁ
préfecture	pʁefɛktyʁ
prépa	pʁepa
prépas	pʁepa
prêtre	pʁɛtʁ
public	pyblik
puces	pys
puisqu'il	pɥiskil
puisqu'ils	pɥiskil
puissante	pɥisɑ̃t
punaise	pynɛz
pupli	pypli
père	pɛʁ
pégase	peɡaz
période	peʁjɔd
périodes	peʁjɔd
périphériques	peʁifeʁik
qu'après	kapʁɛ
qu'au	ko
qu'aux	ko
qu'elle	kɛl
qu'est-ce	kɛ-s
qu'il	kil
qu'ils	kil
qu'on	kɔ̃
qu'un	kɛ̃
qu'une	kyn
qu'à	ka
quand-même	kɑ̃mɛm
quarante	kaʁɑ̃t
quarante-cinq	kaʁɑ̃t-sɛ̃k
quart	kaʁ
quartier	kaʁtje
quatorze	katɔʁz
quatre	katʁ
quel	kɛl
quelqu'un	kɛlkɛ̃
quelque	kɛlk
quelques	kɛlk
question	kɛstjɔ̃
question:	kɛstjɔ̃:
questions	kɛstjɔ̃
quinzaine	kɛ̃zɛn
quinze	kɛ̃z
races	ʁas
radio	ʁadjo
raison	ʁɛzɔ̃
raisons	ʁɛzɔ̃
randos	ʁɑ̃do
rausgekürzt	ʁosʒəkyʁz
ravitaillement	ʁavitajmɑ̃
rayon	ʁɛjɔ̃
recherche	ʁəʃɛʁʃ
refuges	ʁəfyʒ
registre	ʁəʒistʁ
registres	ʁəʒistʁ
relations	ʁəlasjɔ̃
renaud	ʁəno
rendement	ʁɑ̃dmɑ̃
repas	ʁəpa
report	ʁəpɔʁ
représentant	ʁəpʁezɑ̃tɑ̃
représentation	ʁəpʁezɑ̃tasjɔ̃
rer	ʁe
responsabilité	ʁɛspɔ̃sabilite
responsabilités	ʁɛspɔ̃sabilite
responsable	ʁɛspɔ̃sabl
restaurant	ʁɛstɔʁɑ̃
restrictions	ʁɛstʁiksjɔ̃
retraite	ʁətʁɛt
revues	ʁəvy
rg1:	ʁɡyn:
riche	ʁiʃ
riches	ʁiʃ
rigueur	ʁiɡœʁ
rond	ʁɔ̃
rose	ʁoz
roses	ʁoz
roumanie	ʁumani
rue	ʁy
rues	ʁy
russe	ʁys
russes	ʁys
rythmique	ʁitmik
règle	ʁɛɡl
règlement	ʁɛɡləmɑ̃
règles	ʁɛɡl
ré	ʁe
réaction	ʁeaksjɔ̃
réactions	ʁeaksjɔ̃
rédaction	ʁedaksjɔ̃
réduits	ʁedɥi
réel	ʁeɛl
références	ʁefeʁɑ̃s
région	ʁeʒjɔ̃
régional	ʁeʒjɔnal
régions	ʁeʒjɔ̃
république	ʁepyblik
réputation	ʁepytasjɔ̃
réseaux	ʁezo
résidents	ʁezidɑ̃
résultats	ʁezylta
réunion	ʁeynjɔ̃
réunions	ʁeynjɔ̃
réveillon	ʁevɛjɔ̃
rôle	ʁol
s	ɛs
sa	sa
sabbatique	sabatik
sable	sabl
sacrée	sakʁe
saint	sɛ̃
sainte	sɛ̃t
sale	sal
salles	sal
salut	saly
sandwichs	sɑ̃dwiʃ
saxophone	saksɔfɔn
sb1:	sbɛ̃:
sc:	sk:
scandinaves	skɑ̃dinav
science	sjɑ̃s
scientifique	sjɑ̃tifik
scolaire	skɔlɛʁ
scolarisation	skɔlaʁizasjɔ̃
second	səɡɔ̃
secondes	səɡɔ̃d
secrète	səkʁɛt
secrétaire	səkʁetɛʁ
secteur	sɛktœʁ
section	sɛksjɔ̃
seigneur	sɛɲœʁ
seine	sɛn
seize	sɛz
sek	sɛk
sel	sɛl
semaine	səmɛn
semaines	səmɛn
semelle	səmɛl
sens	sɑ̃s
sentiment	sɑ̃timɑ̃
sept	sɛt
septembre	sɛptɑ̃bʁ
septième	sɛtjɛm
service	sɛʁvis
services	sɛʁvis
ses	se
seul	sœl
seule	sœl
seuls	sœl
seuvré	sœvʁe
simple	sɛ̃pl
singe	sɛ̃ʒ
situation	sitɥasjɔ̃
situations	sitɥasjɔ̃
six	sis
siècle	sjɛkl
sl1:	slɛ̃:
sncf	snkf
sociales	sɔsjal
sociaux	sɔsjo
sociétés	sɔsjete
soeur	sɔœʁ
soigner	swaɲe
soir	swaʁ
soirs	swaʁ
soirée	swaʁe
soirées	swaʁe
soixante	swasɑ̃t
sol	sɔl
soldats	sɔlda
soleil	sɔlɛj
solfège	sɔlfɛʒ
sommet	sɔmɛ
son	sɔ̃
sono	sɔno
sorte	sɔʁt
sortes	sɔʁt
sorties	sɔʁti
soucis	susi
soupe	sup
sourire	suʁiʁ
souris	suʁi
sous	su
sous-directeur	susdiʁɛktœʁ
soustasse	sustas
soutien	sutjɛ̃
souvenir	suvəniʁ
souvenirs	suvəniʁ
spectacle	spɛktakl
sportif	spɔʁtif
spécial	spesjal
spéciale	spesjal
spéciales	spesjal
spécialiste	spesjalist
spécialistes	spesjalist
spécialité	spesjalite
st	st
sta	sta
stage	staʒ
statut	staty
studio	stydjo
stupide	stypid
successifs	syksesif
successives	syksesiv
sud	syd
sud-ouest	sydwɛst
suisse	sɥis
suisses	sɥis
suite	sɥit
suivant	sɥivɑ̃
sup	sy
super	sypɛʁ
superbe	sypɛʁb
supérieur	sypeʁjœʁ
supérieures	sypeʁjœʁ
sur	syʁ
surprise	syʁpʁiz
surs	syʁ
suède	sɥɛd
sympa	sɛ̃pa
sympathique	sɛ̃patik
système	sistɛm
systèmes	sistɛm
sébastien	sebastjɛ̃
sécheresse	sɛʃʁɛs
sécurité	sekyʁite
sénégal	seneɡal
séparé	sepaʁe
sérieux	seʁjø
sûr	syʁ
t'es	tɛ
ta	ta
table	tabl
tablier	tablije
talons	talɔ̃
tamise	tamiz
tantôt	tɑ̃to
tapis	tapi
tapisseries	tapisʁi
tarifs	taʁif
tasse	tas
tasses	tas
taureau	tɔʁo
taxi	taksi
tchèque	tʃɛk
technique	tɛknik
technologie	tɛknɔlɔʒi
tel	tɛl
temps	tɑ̃
temps)	tɑ̃)
temps-là	tɑ̃-la
tendresse	tɑ̃dʁɛs
tenez	təne
tenues	təny
term	tɛʁm
terme	tɛʁm
terrain	teʁɛ̃
terrains	teʁɛ̃
tes	te
teuf	tœf
texte	tɛkst
textes	tɛkst
thème	tɛm
thèse	tɛz
thé	te
théière	tejɛʁ
théorèmes	teɔʁɛm
ticket	tikɛ
ticket'	tikɛ'
tickets	tikɛ
tiens	tjɛ̃
tigres	tiɡʁ
tiraille	tiʁaj
titre	titʁ
titres	titʁ
toilettes	twalɛt
ton	tɔ̃
totale	tɔtal
tou	tu
tour	tuʁ
tournée	tuʁne
tous	tu
tout	tu
toute	tut
toutes	tut
tr	tʁ
tradi	tʁadi
traditions	tʁadisjɔ̃
train	tʁɛ̃
tranquilité	tʁɑ̃kilite
transports	tʁɑ̃spɔʁ
travail	tʁavaj
trentaine	tʁɑ̃tɛn
trente	tʁɑ̃t
tri	tʁi
trois	tʁwa
troisième	tʁwazjɛm
trou	tʁu
trous	tʁu
truc	tʁyk
truc-là	tʁyk-la
trucs	tʁyk
tunnel	tynɛl
turc	tyʁk
turc'	tyʁk'
type	tip
types	tip
tâches	taʃ
té	te
télé	tele
téléphone	telefɔn
téléphones	telefɔn
télés	tele
télévision	televizjɔ̃
ténors	tenɔʁ
tête	tɛt
têtes	tɛt
un	ɛ̃
une	yn
unis	yni
universitaire	ynivɛʁsitɛʁ
usine	yzin
v	ve
va	va
vacances	vakɑ̃s
vachement	vaʃmɑ̃
vaisselle	vɛsɛl
valises	valiz
vallée	vale
vallées	vale
valse	vals
vannerie	vanʁi
ve	və
vendredi	vɑ̃dʁədi
ventre	vɑ̃tʁ
ventre'	vɑ̃tʁ'
verbe	vɛʁb
verdredi	vɛʁdʁədi
version	vɛʁsjɔ̃
vert	vɛʁ
vertiges	vɛʁtiʒ
verts	vɛʁ
vf1:	vfɛ̃:
viande	vjɑ̃d
vie	vi
vie'	vi'
vigipirate	viʒipiʁat
village	vilaʒ
villages	vilaʒ
ville	vil
villeneuve	vilnœv
villes	vil
vin	vɛ̃
vingt	vɛ̃
vingt-cinq	vɛ̃t-sɛ̃k
vingt-et-un	vɛ̃t-e-ɛ̃
vingtaine	vɛ̃tɛn
vires	viʁ
virée	viʁe
visage	vizaʒ
visites	vizit
viêt	vjɛ
vo	vo
vocal	vɔkal
voie	vwa
voisin	vwazɛ̃
voisine	vwazin
voisines	vwazin
voisins	vwazɛ̃
voiture	vwatyʁ
voitures	vwatyʁ
voix	vwa
voix)	vwa)
volcans	vɔlkɑ̃
volume	vɔlym
vos	vo
votre	vɔtʁ
vou-lait	vulɛ
voy	vɔj
voyage	vwajaʒ
voyez	vwaje
vrai	vʁɛ
vrais	vʁɛ
vrp	vʁ
vvin	vvɛ̃
vérifications	veʁifikasjɔ̃
vérité	veʁite
véto	veto
vêtements	vɛtmɑ̃
w-c	wk
week-end	wikɑ̃
xb1:	ksbɛ̃:
yaourt	jauʁ
zone	zon
zones	zon
zéro	zeʁo
à-dire	adiʁ
âge	aʒ
âges	aʒ
école	ekɔl
écoles	ekɔl
économique	ekɔnɔmik
écoutes	ekut
éducation	edykasjɔ̃
égyptienne	eʒipsjɛn
élections	elɛksjɔ̃
électricien	elɛktʁisjɛ̃
élèves	elɛv
éléments	elemɑ̃
émoi	emwa
énorme	enɔʁm
épaules	epol
éponge	epɔ̃ʒ
époque	epɔk
épouse	epuz
époux	epu
équipes	ekip
ét	e
étages	etaʒ
étape	etap
état	eta
états	eta
étrangers	etʁɑ̃ʒe
étrangère	etʁɑ̃ʒɛʁ
études	etyd
étudiants	etydjɑ̃
été	ete
évi	evi
êrêtre	eʁɛtʁ